8
0 P 0 0 0 0 0 B
0 S B W T S 0 W
0 0 0 B 0 0 0 W
0 0 0 B 0 T 0 0
0 0 0 B 0 S B 0
0 0 0 B W 0 0 0
0 0 0 0 0 B 0 S
S B T W 0 0 0 S